R 1920 1080

NO ./texture/bluestone.xpm
SO ./texture/eagle.xpm
WE ./texture/greystone.xpm
EA ./texture/redbrick.xpm

S ./texture/sprite.xpm
F 110,100,0
C 115,10,0

111111111111111111111111
100000000000000000000001
100000000000000000000001
100000000000000000000001   11111111
100000000000000000000001111100000001
100000000000000000000000000000000011
10000000000000000000000111110000001
100000000000000000000001   11111111
100000000000000000000001
1000000000000000000000011111111
1000000000002000000000000000001
1000000000002000000000011110001
100000000000200000000001  10001
1000000000002000000000011110001
1000000000002000000000000000001
1000000000000000000000011111111
1000000000000S0000000001
100000000000000000000001
100000000000000000000001
100000000000010011111111
100000000000010000000001
100000000000010000000001
100000000000100000000001
111111111111111111111111
