R 1920 1080

NO ./texture/bluestone.xpm
SO ./texture/eagle.xpm
WE ./texture/greystone.xpm
EA ./texture/redbrick.xpm

S ./texture/sunax.xpm
F 255,10,0
C 0,10,0

111111111111111111111111
100000000000000000000001
100010000000000001000001
1000000000000000000000011111111
1000000000000000000000011000000111
100000001000000000000000000000000011
10000000000000000000000111000000001
1000000000000001000000011111111111
100000000000000000000001
1000000000000000000000011111111
1000000000002000000000000000001
1000000000002000000000011110001
10000000000020000000000111000001
1000000000002000000000011110001
1000000000002000000000000000001
1000000000000000000000011111111
100000000000000000000001
100000010000000000000001
100000000000000000000001
100000000000010011111111
100000000000010000000001
100000S00000010000000001
100000000000100000000001
111111111111111111111111
